┌─────────────────────────────────────────────────────────────────────────────────────────────────────────────────────────────────────────────────────────────────────────────────────────┐                                        
│-----------------------------------------------------------------------------------------------------------------------------------------------------------------------------------------│                                        
│                                                                                           direction Háje                                                                                │                                        
│-----------------------------------------------------------------------------------------------------------------------------------------------------------------------------------------│              ┌───────────────────#####┐
│                                                                                                                                                                                         │              │                        │
│                                                                                                                                                                                         │              │                        │
│                                                                                                                                                                                         │              │                        │
│                                                                                                                                                                                         └──────────────┘                        │
│                                                                                                                                                                                         ................                        │
│                                                                                                                                                                                         ................                        │
│                                                                                            @                                                                                            ────────────────                        │
│                                                                                                                                                                                         ................                        │
│                                                                                                                                                                                         ................                        │
│                                                                                                                                                                                         ┌──────────────┐                        │
│                                                                                                                                                                                         │              │                        │
│                                                                                                                                                                                         │              │                        │
│                                                                                                                                                                                         │              │                        │
│-----------------------------------------------------------------------------------------------------------------------------------------------------------------------------------------│              └───────────────────#####┘
│                                                                                           direction Čakovice                                                                            │                                        
│-----------------------------------------------------------------------------------------------------------------------------------------------------------------------------------------│                                        
└─────────────────────────────────────────────────────────────────────────────────────────────────────────────────────────────────────────────────────────────────────────────────────────┘                                        