                                                                                                                                            ┌────────────────────────────────────────────────────────────────────────────────────────────────────────────────────────────────────────────────────────────────────────────────────────────────────────────────────────────────────────────┐
                                                                                                                                            │       ..............                                                                                                                                                                                       ..............                  │
                                                                                                                                            │       ..............                                                                                                                                                                                       ..............                  │
                                                                                                                                            │       ..............                                                                                                                                                                                       ..............                  │
                                                                                                                                            │       ..............                                                                                                                                                                                       ..............                  │
                                                                                                                                            │       ┌────────────┐                                                                                                                                                                                       ┌────────────┐                  │
                                                                                                                                            │       │            │                                                                                                                                                                                       │            │                  │
                                                          ┌─────────────────────────────────────────────────────────────────────────────────┘       │            │~~~~~~~~~~~~~~~~~~~~~~~~~~~~~~~~~~~~~~~~~~~~~~~~~~~~~~~~~~~~~~~~~~~~~~~~~~~~~~~~~~~~~~~~~~~~~~~~~~~~~~~~~~~~~~~~~~~~~~~~~~~~~~~~~~~~~~~~~~~~~~~~~~~~~~~~~~~~~~~~~~~~~~~~~~~~~~~~~~~~~~~│            │                  │
                                                          │                                ..............................................           │            │                                                                                                                                                                                       │            │                  │
                                                          │                                ..............................................           │            │~~~~~~~~~~~~~~~~~~~~~~~~~~~~~~~~~~~~~~~~~~~~~~~~~~~~~~~~~~~~~~~~~~~~~~~~~~~~~~~~~~~~~~~~~~~~~~~~~~~~~~~~~~~~~~~~~~~~~~~~~~~~~~~~~~~~~~~~~~~~~~~~~~~~~~~~~~~~~~~~~~~~~~~~~~~~~~~~~~~~~~~│            │                  │
                                                          │                                ──────────────────────────────────────────────           │            │                                                                                                                                                                                       │            │                  │
                                                          │                                ..............................................           │            │~~~~~~~~~~~~~~~~~~~~~~~~~~~~~~~~~~~~~~~~~~~~~~~~~~~~~~~~~~~~~~~~~~~~~~~~~~~~~~~~~~~~~~~~~~~~~~~~~~~~~~~~~~~~~~~~~~~~~~~~~~~~~~~~~~~~~~~~~~~~~~~~~~~~~~~~~~~~~~~~~~~~~~~~~~~~~~~~~~~~~~~│            │                  │
                                                          │                                ..............................................           │            │                                                                                                                                                                                       │            │                  │
                                                          │       ┌─────────────────────────────────────────────────────────────────────────┐       │            │~~~~~~~~~~~~~~~~~~~~~~~~~~~~~~~~~~~~~~~~~~~~~~~~~~~~~~~~~~~~~~~~~~~~~~~~~~~~~~~~~~~~~~~~~~~~~~~~~~~~~~~~~~~~~~~~~~~~~~~~~~~~~~~~~~~~~~~~~~~~~~~~~~~~~~~~~~~~~~~~~~~~~~~~~~~~~~~~~~~~~~~│            │                  │
                                                          │       │                                                                         │       │            │                                                                                                                                                                                       │            │                  │
                                                          │       │                                                                         │       └────────────┘                                                                                                                                                                                       └────────────┘                  │
                                                          │       │                                                                         │       ..............                                                                                                                                                                                       ..............                  │
                                                          │       │                                                                         │       ..............                                                                                                                                                                                       ..............                  │
                                                          │       │                                                                         │       ..............                                                                                                                                                                                       ..............                  │
                                                          │       │                                                                         │       ..............                                                                                                                                                                                       ..............                  │
                                                          │       │                                                                         └────────────────────────────────────────────────────────────────────────────────────────────────────────────────────────────────────────────────────────────────────────────────────────────────────────────────────────────────┐.....│.....│
                                                          │       │                                                                                                                                                                                                                                                                                                          │.....│.....│
                                                          │       │                                                                                                                                                                                                                                                                                                          │.....│.....│
                                                          │       │                                                                                                                                                                                                                                                                                                          │.....│.....│
                                                          │       │                                                                                                                                                                                                                                                                                                          │.....│.....│
                                                          │       │                                                                                                                                                                                                                                                                                                          │.....│.....│
                                                          │       │                                                                                                                                                                                                                                                                                                          │.....│.....│
─────────────────────────────────┐                        │       │                                                                                                                                                                                                                                                                                                          │.....│.....│
#                                │                        │       │                                                                                                                                                                                                            ───────────────────────                                                                       │.....│.....│
#                                │                        │       │                                                                                                                                                                                                            #                     #                                                                       │.....│.....│
#                                │                        │       │                                                                                                                                             ┌────────────────────────────────────────┐                     #                     #                                                                       │.....│.....│
#                                │                        │       │                                                                                                                                             │                                        │                     #                     #                                                                       │.....│.....│
───────────────────────┐         │                        │       │                                                                                                                                             │                                        │                     ─────┐        ┌─────────────────┬─────────┬─────────────┐                                     │.....│.....│
                       │         │                        │       │                                                                                                                                             │                                        │                          │        │                 │         │             │                                     │.....│.....│
                       │         │                        │       │                                                                                                                                             │                                        │                          │        │                 │         │             │                                     │.....│.....│
                       │         │                        │       │                                                                                                                                             │                                        │                          │        │                 │         │             │                                     │.....│.....│
                       │         │                        │       │                                                                                                                                             ├────────────────────────────            │                          │        │                 │         │             │                                     │.....│.....│
                       │         └────────────────────────┘       │                                                                                                                                             │                                        │                          │        │      ───────────┘         │             │                                     │.....│.....│
                       │                                          │                                                                                                                                             │                                        └──────────────────────────┘        │                           │             │                                     │.....│.....│
                       │                                          │                                                                                                                                             │                                                                            =                           │             │                                     │.....│.....│
                       │                                          │                                                                                                                                             │                                                                            =                           │             │                                     │.....│.....│
                       │                                          │                                                                                                                                             │                                                                            =                           └─────────    │                                     │.....│.....│
                       │         ┬────────────────────────────────┘                                                                                                                                             └───────────────────────────────────────────────────────────────────┐        │        ────┐                            │                                     │.....│.....│
                       │         │                                                                                                                                                                                                                                                  │        │            │                            │                                     │.....│.....│
                       │         │                                                                                                                                                                                                                                                  │        │            │                            │                                     │.....│.....│
                       │         │                   ┌─────────────────────────────────────────────────────────────────────────────────────────────────────────────────────────────────────────────────────────────────────────────────────────┐                                    │        │            │                            │                                     │.....│.....│
                       │         │                   │-----------------------------------------------------------------------------------------------------------------------------------------------------------------------------------------│                                    │        │            │                            │                                     │.....│.....│
                       │         │                   │                                                                                           direction Úhříněves                                                                           │                                    │        ├────────────┴────────────────────────────┤                                     │.....│.....│
                       │         │                   │-----------------------------------------------------------------------------------------------------------------------------------------------------------------------------------------│                                    │        │                                         │                                     │.....│.....│
                       │         │                   │                                                                                                                                                                                         │                                    │        =                                         │                                     │.....│.....│
                       │         │                   │                                                                                                                                                                                         │                                    │        =                                         │                                     │.....│.....│
                       │         │                   │                                                                                                                                                                                         │                                    │        │                                         │                                     │.....│.....│
                       │         └───────────────────┘                                                                                                                                                                                         └────────────────────────────────────┘        └─────────────────────────────────────────┴─────────────────────────────────────┘.....│.....│
                       │         .....................                                                                                                                                                                                         .................                                                                                                                         │
                       │         .....................                                                                                                                                                                                         .................                                                                                                                         │
                       │         ─────────────────────                                                                                            @                                                                                            ─────────────────                                                                                                                         │
                       │         .....................                                                                                                                                                                                         .................                                                                                                                         │
                       │         .....................                                                                                                                                                                                         .................                         ┌───────────────────────────────────────────────┐          ┌────────────────────────────────────┘
                 ┌─────┘        ┌────────────────────┐                                                                                                                                                                                         ┌──────────────────┐                      │                                               │          │
                 │              │                    │                                                                                                                                                                                         │                  │                      │                                               │          │
                 │              │                    │                                                                                                                                                                                         │                  │                      │                                               │          │
                 │              │                    │                                                                                                                                                                                         │                  │                      │                                               │          │
                 │              │                    │-----------------------------------------------------------------------------------------------------------------------------------------------------------------------------------------│                  │                      │                                  ─────────────┘          └─────────
                 │              │                    │                                                                                           direction Čakovice                                                                            │                  │                      │                                  #                                #
                 │              │                    │-----------------------------------------------------------------------------------------------------------------------------------------------------------------------------------------│                  │                      │                                  #                                #
                 │              │                    └─────────────────────────────────────────────────────────────────────────────────────────────────────────────────────────────────────────────────────────────────────────────────────────┘                  │                      │                                  #                                #
                 │              │                                                                                                                                                                                                                                 │                      │                                  #                                #
                 │              │                                                                                                                                                                                                                                 │                      │                                  ──────────────────────────────────
                 │              │                                                                                                                                                                                                                                 │######################│
                 │              │
                 │              │                        │#####│
                 │              │                        │     │
                 │              │                        │     │
                 │              │                        │     │
     ┌───────────┘              └────────────────────────┘     │
     │                                                         │
     │                                                         │
     │                                                         │
     │                                                         │
     │    ┌──────────────────────────────────────────────┐     │
     │    │                                              │     │
     │    │                                              │     │
     │    │                                              │     │
     │    │                                              │     │
     │    │                                              │#####│
     │    │
     │    │
     │    │
     │    │
     │    │
     │    │
     │####│