              ┌───────────────┐                        ┌─────────────────────────────────────────────────────────────────────────────────────────────────────────────────────────────────────────────────────────────────────────────────────────┐
              │               │                        │-----------------------------------------------------------------------------------------------------------------------------------------------------------------------------------------│
              │               │                        │                                                                                           direction Háje                                                                                │
              │               │                        │-----------------------------------------------------------------------------------------------------------------------------------------------------------------------------------------│
              │               │                        │                                                                                                                                                                                         │         ┌──────#####──────┐
              │               │                        │                                                                                                                                                                                         │         │                 │
              │               │                        │                                                                                                                                                                                         │         │                 │
              │               └────────────────────────┘                                                                                                                                                                                         └─────────│                 │
              │                                                                                                                                                                                                                                  ..........│                 #
              │                                                                                                                                                                                                                                  ..........│                 #
              │                                                                                                                                     @                                                                                            ──────────│                 #
              │                                                                                                                                                                                                                                  ..........│                 #
              │                                                                                                                                                                                                                                  ..........│                 #
              │               ┌────────────────────────┐                                                                                                                                                                                         ┌─────────│                 │
              │               │                        │                                                                                                                                                                                         │         │                 │
              │               │                        │                                                                                                                                                                                         │         │                 │
              │               │                        │                                                                                                                                                                                         │         └─────────────────┘
              │               │                        │-----------------------------------------------------------------------------------------------------------------------------------------------------------------------------------------│
              │               │                        │                                                                                           direction Čakovice                                                                            │
──────────────┘    ───────    └────────────            │-----------------------------------------------------------------------------------------------------------------------------------------------------------------------------------------│
#                                         #            └─────────────────────────────────────────────────────────────────────────────────────────────────────────────────────────────────────────────────────────────────────────────────────────┘
#                                         #
#                                         #
#                                         #
#                                         #
───────────────────────────────────────────