                                                             ┌──────────────────────────────────────────────┐
                                                             │                                              │
                                                             │                                              │
                                                             │                                              │
│##########│                │##########│                     │    ──────────────────────────────────────    ┼────┐
│          │                │          │                     │                                              │    │
│          │                │          │                     │                                              │    │
│          │                │          │                     │                                              │    │
│          │                │          │                     │                                              =    │            ┌─────────────────────────────────────────────────────────────────────────────────────────────────────────────────────────────────────────────────────────────────────────────────────────┐
│          │                │          │                     │                                              =    │            │-----------------------------------------------------------------------------------------------------------------------------------------------------------------------------------------│
│          │                │          │                     │                                              │    │            │                                                                                           direction Háje                                                                                │
│          │                │          │                     │                                              │    │            │-----------------------------------------------------------------------------------------------------------------------------------------------------------------------------------------│
│          │                │          │                     │                                              │    │            │                                                                                                                                                                                         │
│          └────────────────┘          └─────────────────────┘                   ───────────────────────────┴────┤            │                                                                                                                                                                                         │
│                                                                                                                │            │                                                                                                                                                                                         │
│                                                                                                                └────────────┘                                                                                                                                                                                         │
│                                                                                                                ..............                                                                                                                                                                                         │
│                                                                                                                ..............                                                                                                                                                                                         │
│                                                                                                                ──────────────                                                                                                          @                                                                              │
│                                                                                                                ..............                                                                                                                                                                                         │
│                                                                                                                ..............                                                                                                                                                                                         │
│                                                                                                                ┌────────────┐                                                                                                                                                                                         │
│                                                                                                                │            │                                                                                                                                                                                         │
│          ┌────────────────┐          ┌─────────────────────┐                   ───────────────────────    ┌────┤            │                                                                                                                                                                                         │
│          │                │          │                     │                                              │    │            │                                                                                                                                                                                         │
│          │                │          │                     │                                              │    │            │-----------------------------------------------------------------------------------------------------------------------------------------------------------------------------------------│
│          │                │          │                     │                                              │    │            │                                                                                           direction Čakovice                                                                            │
│          │                │          │                     │                                              =    │            │-----------------------------------------------------------------------------------------------------------------------------------------------------------------------------------------│
│          │                │          │                     │                                              =    │            └─────────────────────────────────────────────────────────────────────────────────────────────────────────────────────────────────────────────────────────────────────────────────────────┘
│          │                │          │                     │                                              │    │
│          │                │          │                     │                                              │    │
│          │                │          │                     │                                              │    │
│##########│                │##########│                     │    ──────────────────────────────────────────┼────┘
                                                             │                                              │
                                                             │                                              │
                                                             │                                              │
                                                             └──────────────────────────────────────────────┘