                                                                                                                                                                                                                                     ────────────────────────────
                                                                                                                                                                                                                                     #                          #
                                                                                                                                                                                                                                     #                          #
                                                                                                                                                                                                                                     #                          #
                                                                                                                                                                                                                                     #                          #
┌─────────────────────────────────────────────────────────────────────────────────────────────────────────────────────────────────────────────────────────────────────────────────────────┐                                          ─────┐         ┌────────────
│-----------------------------------------------------------------------------------------------------------------------------------------------------------------------------------------│                                               │         │
│                                                                                           direction Háje                                                                                │                                               │         │
│-----------------------------------------------------------------------------------------------------------------------------------------------------------------------------------------│                                               │         │
│                                                                                                                                                                                         │                                               │         │
│                                                                                                                                                                                         │                            ┌──────────────────┘         │
│                                                                                                                                                                                         │                            │                            │
│                                                                                                                                                                                         └────────────────────────────┘                            │
│                                                                                                                                                                                         ..............................                            │
│                                                                                                                                                                                         ..............................                            │
│                                                                                            @                                                                                            ──────────────────────────────                            │
│                                                                                                                                                                                         ..............................                            │
│                                                                                                                                                                                         ..............................                            │
│                                                                                                                                                                                         ┌────────────────────────────┐                            │
│                                                                                                                                                                                         │                            │                            │
│                                                                                                                                                                                         │                            └──────────────────┐         │
│                                                                                                                                                                                         │                                               │         └──────────────
│-----------------------------------------------------------------------------------------------------------------------------------------------------------------------------------------│                                               │                       #
│                                                                                           direction Čakovice                                                                            │                                               │                       #
│-----------------------------------------------------------------------------------------------------------------------------------------------------------------------------------------│                                               │                       #
└─────────────────────────────────────────────────────────────────────────────────────────────────────────────────────────────────────────────────────────────────────────────────────────┘                                               │                       #
                                                                                                                                                                                                                                          │         ┌──────────────
                                                                                                                                                                                                                                          │         │
                                                                                                                                                                                                                                          │         │
                                                                                                                                                                                                                                          │         │
                                                                                                                                                                                                                                          │         │
                                                                                                                                                                                                                                          │         │
                                                                                                                                                                                                                                          │         │
                                                                                                                                                                                                                                          │         │
                                                                                                                                                                                                                                          │         │
                                                                                                                                                                                                                                          │         │
                                                                                                                                                                                                                                          │         │
                                                                                                                                                                                                                                          │         │
                                                                                                                                                                                                                                          │         │
                                                                                                                                                                                                                                    ──────┘         │
                                                                                                                                                                                                                                    #               │
                                                                                                                                                                                                                                    #               │
                                                                                                                                                                                                                                    #               │
                                                                                                                                                                                                                                    #               │
                                                                                                                                                                                                                                    #               │
                                                                                                                                                                                                                                    ────────────────┘