                                                                                                                                                                                                                                       ──────────────────────┐
┌─────────────────────────────────────────────────────────────────────────────────────────────────────────────────────────────────────────────────────────────────────────────────────────┐                                            #                     │
│-----------------------------------------------------------------------------------------------------------------------------------------------------------------------------------------│                                            #                     │
│                                                                                           direction Háje                                                                                │                                            #                     │
│-----------------------------------------------------------------------------------------------------------------------------------------------------------------------------------------│                                            #                     │
│                                                                                                                                                                                         │                                            ──────────────┐       │
│                                                                                                                                                                                         │                              ┌──────────────────────────┐│       │
│                                                                                                                                                                                         │                              │                          ││       │
│                                                                                                                                                                                         └──────────────────────────────┘                          ││       │
│                                                                                                                                                                                         ................................                          ││       │
│                                                                                                                                                                                         ................................                          └┘       │
│                                                                                            @                                                                                            ────────────────────────────────                                   │
│                                                                                                                                                                                         ................................                                   │
│                                                                                                                                                                                         ................................                                   │
│                                                                                                                                                                                         ┌──────────────────────────────┐                                   │
│                                                                                                                                                                                         │                              │                                   │
│                                                                                                                                                                                         │                              └──────────┐                        │
│                                                                                                                                                                                         │                                 ────────┘                        └────────────
│-----------------------------------------------------------------------------------------------------------------------------------------------------------------------------------------│                                 #                                            #
│                                                                                           direction Čakovice                                                                            │                                 #                                            #
│-----------------------------------------------------------------------------------------------------------------------------------------------------------------------------------------│                                 #                                            #
└─────────────────────────────────────────────────────────────────────────────────────────────────────────────────────────────────────────────────────────────────────────────────────────┘                                 ──────────────────────────────────────────────