┌─────────────────────────────────────────────────────────────────────────────────────────────────────────────────────────────────────────────────────────────────────────────────────────┐
│-----------------------------------------------------------------------------------------------------------------------------------------------------------------------------------------│
│                                                                                           direction Háje                                                                                │
│-----------------------------------------------------------------------------------------------------------------------------------------------------------------------------------------│                                ┌─────────────────────────
│                                                                                                                                                                                         │                                │                        #
│                                                                                                                                                                                         │                                │                        #
│                                                                                                                                                                                         │                                │                        #
│                                                                                                                                                                                         └────────────────────────────────┘                        #
│                                                                                                                                                                                         ..................................                        #
│                                                                                                                                                                                         ..................................                        #
│                                                                                            @                                                                                            ──────────────────────────────────                        #
│                                                                                                                                                                                         ..................................                        #
│                                                                                                                                                                                         ..................................                        #
│                                                                                                                                                                                         ┌────────────────────────────────┐                        #
│                                                                                                                                                                                         │                                │                        #
│                                                                                                                                                                                         │                                │                        #
│                                                                                                                                                                                         │                                │                        #
│-----------------------------------------------------------------------------------------------------------------------------------------------------------------------------------------│                                └─────────────────────────
│                                                                                           direction Čakovice                                                                            │
│-----------------------------------------------------------------------------------------------------------------------------------------------------------------------------------------│
└─────────────────────────────────────────────────────────────────────────────────────────────────────────────────────────────────────────────────────────────────────────────────────────┘