┌────────────────────────────────────────────────────────────────────────────────────────────────────────────────────────────────────────────────────────────────────────────────────────────────────────────┐
│                                                                                                                                                                                                            │
│                                                                                                                                                                                                            │
├────────────────────────────────────────────────────────────────────────────────────────────                    ────────────────────────────────────────────────────────────────────────────────────────────┤
│                                                                 ...........................                    ...........................                                                                 │
│                                                                 ...........................                    ...........................                                                                 │
│                                                                 ...........................                    ...........................                                                                 │
│                                                                 ...........................                    ...........................                                                                 │
│                                                                 ──────────────────────────┐                    ┌──────────────────────────                                                                 │
│                                                                                           │                    │                                                                                           │
│                                                                                           │                    │                                                                                           │
│                                                                                           │                    │                                                                                           │
│                                                                                           │                    │                                                                                           │
│                                                                                           │                    │                                                                                           │
│-------------------------------------------------------------------------------------------│                    └┐------------------------------------------------------------------------------------------│
│                                                                     direction Uhříněves   │                    ►│                                                                                          │
│-------------------------------------------------------------------------------------------│                    ►│------------------------------------------------------------------------------------------│
│┌─┐    ┌─┐    ┌─┐    ┌─┐    ┌─┐    ┌─┐    ┌─┐    ┌─┐    ┌─┐    ┌─┐    ┌─┐    ┌─┐    ┌─┐    │                    ►│   ┌─┐    ┌─┐    ┌─┐    ┌─┐    ┌─┐    ┌─┐    ┌─┐    ┌─┐    ┌─┐    ┌─┐    ┌─┐    ┌─┐    ┌─┐│
││ │    │ │    │ │    │ │    │ │    │ │    │ │    │ │    │ │    │ │    │ │    │ │    │ │    │          @         ►│   │ │    │ │    │ │    │ │    │ │    │ │    │ │    │ │    │ │    │ │    │ │    │ │    │ ││
│└─┘    └─┘    └─┘    └─┘    └─┘    └─┘    └─┘    └─┘    └─┘    └─┘    └─┘    └─┘    └─┘    │                    ►│   └─┘    └─┘    └─┘    └─┘    └─┘    └─┘    └─┘    └─┘    └─┘    └─┘    └─┘    └─┘    └─┘│
│-------------------------------------------------------------------------------------------│                    ►│------------------------------------------------------------------------------------------│
│                                                                      direction Čakovice   │                    ►│                                                                                          │
│-------------------------------------------------------------------------------------------│                    ┌┘------------------------------------------------------------------------------------------│
│                                                                                           │                    │                                                                                           │
│                                                                                           │                    │                                                                                           │
│                                                                                           │                    │                                                                                           │
│                                                                                           │                    │                                                                                           │
│                                                                                           │                    │                                                                                           │
│                                                                 ──────────────────────────┘                    └──────────────────────────                                                                 │
│                                                                 ...........................                    ...........................                                                                 │
│                                                                 ...........................                    ...........................                                                                 │
│                                                                 ...........................                    ...........................                                                                 │
│                                                                 ...........................                    ...........................                                                                 │
├────────────────────────────────────────────────────────────────────────────────────────────                    ────────────────────────────────────────────────────────────────────────────────────────────┤
│                                                                                                                                                                                                            │
│                                                                                                                                                                                                            │
└────────────────────────────────────────────────────────────────────────────────────────────────────────────────────────────────────────────────────────────────────────────────────────────────────────────┘