                                                                                                                                                                                                                                                                                                                                                                     │##############│
                                                                                                                                                                                                                                                                                                                                                                     │              │
                                                                                                     ┌───────────────────┬──────────────────────────┬───────┬───────────────────────┐                                                                                                                                                                                │              │
                                                                                                     │                   │           ┌─┐            │       │                       │                                                                                                                                                                                │              │
                                                                                                     │                   │           └─┘            │       │                       │                                                                                                                                                                                │              │
  ┌────────────────────────────────────────────────────────┐                                         │                   │                          │       │                       │                                                                                                                                                                                │              │
  │                                                        │                                         │                   │                          │       │                       │                                                                                                                                                                                │              │
  │                                                        │                                         │                   │            │             │       │                       │                                                                                                                                                                                │              │
  │         │    │      ┌───────       ┌───────            │                                         │                   │            │             │       │                       │                                                                                                                                                                                │              │
  │         │    │      │              │                   │                                         │                   │            │      ┌──────┤       │                       │                                                                                                                                                                                │              │
  │         │    │      │              │                   │                                         │                   │            │      │      │       │                       │                                                                                                                                                                                │              │
  │         │  ┌─┘      │              │                   │                                         │                   │            │      │      │       │                       │                                                                                                                                                                                │              │
  │         ┼──┤        │              │                   │                                         │                   │            │      │      │       │                       │                                                                                                                                                                                │              │
  │         │  └─┐      ├───────       │                   │                                         │                   └───────     │      └──────┘       └──────────             │                                                                                                                                                                                │              │
  │         │    │      │              │                   │                                         │                                                                              │                                                                                                                                                                                │              │
  │         │    │      │              │                   │                                         │                                                                              │                                                                                                                                                                                │              │
  │         │    │      │              └───────            │                                         │                                                                              │                                                                                                                                                                                │              │
  │                                                        │                                         │                                                                              │                                                                                                                                                                                │              │
  │                                                        │                                         │                                                                              │                                                                                                                                                                                │              │
  └────────────────────────────────────────────────────────┘─────────────────────────────────────────└────────        ──────────────────────────────────────────────────────────────┘────────────────────────────────────────────────────────────────────────────────────────────────────────────────────────────────────────────────────────────────────────────────┘              │
  │                                                                                                                                                                                                                                                                                                                                                                                 │
  │                                                                                                                                                                                                                                                                                                                                                                                 │
  │                                                                                                                                                                                                                                                                                                                                                                                 │
  │                                                                                                                                                                                                                                                                                                                                                                                 │
  │                                                                                                                                                                                                                                                                                                                                                                                 │
  │                                                                                                                                                                                                                                                                                                                                                                                 │
  │                                                                                                                                                                                                                                                                                                                                                                                 │
  │                                                                                                                                                                                                                                                                                                                                                                                 │
──┴────────────────                   ┌───────────────────────┐                                                                                                                                                                                                 ┌───────────────────────┐                                                                                           │
#..................                   │         ────────────┐ │                                                                                                                                                                                                 │                       │                                                                                           │
#..................                             ...........▼│ │                                                                                                                                                                                                 │─────────                                                                                                          │
#..................                             ...........▼│ │                                                                                                                                                                                                 │▲........                                                                                                          │
#..................                             ...........▼│ │                                                                                                                                                                                                 │▲........                                                                                                          │
#..................                             ...........▼│ │                                                                                                                                                                                                 │─────────                                                                                                          │
#..................                             ...........▼│ │                                                                                                                                                                                                 │▲........                                                                                                          │
#..................                             ...........▼│ │                                                                                                                                                                                                 │▲........                                                                                                          │
#..................                             ...........▼│ │                                                                                                                                                                                                 │─────────                                                                                                          │
#..................                   │         ────────────┘ │                                                                                                                                                                                                 │                       │                                                                                           │
──┬────────────────                   └───────────────────────┘                                                                                                                                                                                                 └───────────────────────┘                                                                                           │
  │                                                                                                                                                                                                                                                                                                                                                                                 │
  │                                                                                                                                                                                                                                                                                                                                                                                 │
  │                                                                                                                                                                                                                                                                                                                                                                                 │
  │                                                                                                                                                                                                                                                                                                                                                                                 │
  │                                                                                                                                                                                                                                                                                                                                                                                 │
  │                                                                                                                                                                                                                                                                                                                                                                                 │
  │                                                                                                                                                                                                                                                                                                                                                                                 │
  │                                                                                                                                                                                                                                                                                                                                                                                 │
  └─────────────────┐                 ┌────      ──────────────┐                ┌──────────────────────────────            ────────────┬────────────────────────────────────────────────────────────────────────────────────┬────────────────┬─────────────┬─────────────    ────────────────────────────┬───────┐             ┌──────────────────────────────────────┐             │
                    │.....│...........│                        │.....│..........│                                                      │                                                                                    │                │             │                                             │       │......│......│                                      │......│......│
                    │.....│...........│                        │.....│..........│                                                      │                                                                                    │                │             │                                             │       │......│......│                                      │......│......│
                    │.....│...........│                        │.....│..........│                                                      │                                                                                    │                │             │                                             │       │......│......│                                      │......│......│
                    │.....│...........│                        │.....│..........│                                                      │      ─────┐                                                                        │                │             │                                             │       │......│......│                                      │......│......│
                    │.....│...........│                        │.....│..........│        ────────┐                                     │           │                                                                        │                │             │                                             │       │......│......│                                      │......│......│
                    │.....│...........│                        │.....│..........│                │                                     │           │                  ┌────────────────────────────────                     │                │             │                                             │       │......│......│                                      │......│......│
                    │.....│...........└────────────────────────┘.....│..........│                │                                     │           │                  │                                                     │                │             │                                             │       │......│......│                                      │......│......│
                    │.....│...........│                        │.....│..........│                │                                     │           │                  │                                                     │                │             │                                             │       │......│......│                                      │......│......│
                    │.....│...........│                        │.....│..........│                │                  ───────────────────┘           │                  │                                                     │                │             └───────────                                  │       │......│......│                                      │......│......│
                    │.....│...........│                        │.....│..........│                │                                                 │                  │                                                     │                │                                                           │       │......│......│                                      │......│......│
                    │.....│...........│                        │.....│..........│                │                                                 │                  │                                                     │                │                                                           │       │......│......│                                      │......│......│
                    │.....│...........│                        │.....│..........│                │                                                 │                  │                                                     │                │                                                   ────────┘       │......│......│                                      │......│......│
                    │#####│###########│                        │#####│##########│                │                                                 │                  │                                                                      │                                                                   │......│......│                                      │......│......│
                                                                                │                │                                                 │                  │                                                                      │                                                                   │......│......│                                      │......│......│
                                                                                │                │                                                 │                  │                                                                      │                                                                   │......│......│                                      │......│......│
                                                                                └────────────────┴─────────────────────────────────────────────────┴──────────────────┴──────────────────────────────────────────────────────────────────────┴───────────────────────────────────────────────────────────────────┘#############│                                      │#############│