┌────────────┐
│▲          ▼│
│▲          ▼│
│▲          ▼│
└───┐     ┌──┘
    │     │
    │     │
    │     │
    │     │
    │     │                      ┌──────────────────────────────────────────────────────────────────────────────────────────────────────────────────────────────────────────────┐
    │     │                      │~~~~~~~~~~~~~~~~~~~~~~~~~~~~~~~~~~~~~~~~~~~~~~~~~~~~~~~~~~~~~~~~~~~~~~~~~~~~~~~~~~~~~~~~~~~~~~~~~~~~~~~~~~~~~~~~~~~~~~~~~~~~~~~~~~~~~~~~~~~~~~│
    │     │                      │                                                          direction Pankrác                                                                   │
    │     │                      │~~~~~~~~~~~~~~~~~~~~~~~~~~~~~~~~~~~~~~~~~~~~~~~~~~~~~~~~~~~~~~~~~~~~~~~~~~~~~~~~~~~~~~~~~~~~~~~~~~~~~~~~~~~~~~~~~~~~~~~~~~~~~~~~~~~~~~~~~~~~~~│
    │     │                      │                                                                                                                                              │
    │     │                      │                                                                                                                                              │
    │     │                      │                                                                                                                                              │
    │     └──────────────────────┘                                                                                                                                              │
    │                                                                                                                                                                           │
    │                                                                                                                                                                           │
    │                                                                                              $                                                                            │
    │                                                                                                                                                                           │
    │                                                                                                                                                                           │
    └────────────────────────────┐                                                                                                                                              │
                                 │                                                                                                                                              │
                                 │                                                                                                                                              │
                                 │                                                                                                                                              │
                                 │~~~~~~~~~~~~~~~~~~~~~~~~~~~~~~~~~~~~~~~~~~~~~~~~~~~~~~~~~~~~~~~~~~~~~~~~~~~~~~~~~~~~~~~~~~~~~~~~~~~~~~~~~~~~~~~~~~~~~~~~~~~~~~~~~~~~~~~~~~~~~~│
                                 │                                                           direction Dvorce                                                                   │
                                 │~~~~~~~~~~~~~~~~~~~~~~~~~~~~~~~~~~~~~~~~~~~~~~~~~~~~~~~~~~~~~~~~~~~~~~~~~~~~~~~~~~~~~~~~~~~~~~~~~~~~~~~~~~~~~~~~~~~~~~~~~~~~~~~~~~~~~~~~~~~~~~│
                                 └──────────────────────────────────────────────────────────────────────────────────────────────────────────────────────────────────────────────┘