          ┌─────────┐                                            ┌──────────┐
          │         │                                            │          │
          │         │                                            │          │
┌─────────┘         └────────────────────────────────────────────┘          └────────────────────────────────────────────────────────────────────┐
│                                                                                                                                                │
│                                                                                                                                                │
│                                                                                                                                                │
│                                                                                                                                                │
│-----------------------------------------------------------------------------------------------------------------------------------------------─┤
│                                                      direction Úhříněves                                                                       │
│------------------------------------------------------------------------------------------------------------------------------------------------│
│                                                                                                                                                │
│------------------------------------------------------------------------------------------------------------------------------------------------│
│                                                       direction Čakovice                                                                       │
│------------------------------------------------------------------------------------------------------------------------------------------------│
│                                                                                                                                                │
│                                                                                                                                                │
│                                                                                                                                                │
│                                                                                                                                                │
└─────────┐         ┌────────────────────────────────────────────┐          ┌────────────────────────────────────────────────────────────────────┘
          │         │                                            │          │
          │         │                                            │          │
          └─────────┘                                            └──────────┘