┌───────────────────────────────┐
│                               │
│              │                │
│              │                │
│              │                │
│              │                │
│              │       │        │
│              │       └────────┤
│              │                │
│              │                │
│              │                │
│              │                │
┼──────────────┘                │
│                               │
│                               │
│                               │
│                               │
│                               │            ┌─────────────────────────────────────────────────────────────────────────────────────────────────────────────────────────────────────────────────────────────────────────────────────────┐             ┌───────────────────────────────────────────┐
│                               │            │-----------------------------------------------------------------------------------------------------------------------------------------------------------------------------------------│             │                                           │
│                               │            │                                                                                           direction Háje                                                                                │             │                                           │
│                               │            │-----------------------------------------------------------------------------------------------------------------------------------------------------------------------------------------│             │                                           │
│                               │            │                                                                                                                                                                                         │             │                                           │
│                               │            │                                                                                                                                                                                         │             │                                           │
│                               │            │                                                                                                                                                                                         │             │                                           │
│                               └────────────┘                                                                                                                                                                                         ├─────────────┴──────────                                 │
│                                .............                                                                                                                                                                                         │.............                                            │
│                                .............                                                                                                                                                                                         │.............                                            │
│                                ─────────────                                                                                             @                                                                                           ├─────────────                                            │
│                                .............                                                                                                                                                                                         │.............                                            │
│                                .............                                                                                                                                                                                         │.............                                            │
│                               ┌────────────┐                                                                                                                                                                                         ├─────────────┬──────────                                 │
├──────────────────────         │            │                                                                                                                                                                                         │             │                                           │
│                               │            │                                                                                                                                                                                         │             │                                           │
│                               │            │                                                                                                                                                                                         │             │                                           │
│                               │            │-----------------------------------------------------------------------------------------------------------------------------------------------------------------------------------------│             │                                           │
│                               │            │                                                                                           direction Čakovice                                                                            │             │                                           │
│                               │            │-----------------------------------------------------------------------------------------------------------------------------------------------------------------------------------------│             │                                           │
└───────────────────────────────┘            └─────────────────────────────────────────────────────────────────────────────────────────────────────────────────────────────────────────────────────────────────────────────────────────┘             └───────────────────────────────────────────┘