                                                                                                                                                                                                                                                     
                                                                                                                                                                                                                                                     
                    ┌───────────────────────────────────────────────────────────────────────────────────────────────────────────────────────────────────────────────────────────────────────────────────────────────────────────────────┐            
                    │-------------------------------------------------------------------------------------------------------------------------------------------------------------------------------------------------------------------│            
                    │                                                                                           direction Úhříněves                                                                                                     │            
                    │-------------------------------------------------------------------------------------------------------------------------------------------------------------------------------------------------------------------│            
                    │                                                                                                                                                                                                                   │            
                    │                                                                                                                                                                                                                   │            
                    │                                                                                                                                                                                                                   │            
────────────────────┘                                                                                               ───────┐                                                                                                            └───────────┐
#                                                                                                                   ......v│                                                                                                                       ►│
#                                                                                                                   ......v│                                                                                                                       ►│
─────────────────────                                                                                               ───────┤                                                                                                                       ►│
#                                                                                                                   ......v│                                                                                                                       ►│
#                                                                                                                   ......v│                                                                                                                       ►│
────────────────────┐                                                                                               ───────┘                                                                                                            ┌───────────┘
                    │                                                                                                                                                                                                                   │            
                    │                                                                                                                                                                                                                   │            
                    │                                                                                                                                                                                                                   │            
                    │-------------------------------------------------------------------------------------------------------------------------------------------------------------------------------------------------------------------│            
                    │                                                                                           direction Čakovice                                                                                                      │            
                    │-------------------------------------------------------------------------------------------------------------------------------------------------------------------------------------------------------------------│            
                    └───────────────────────────────────────────────────────────────────────────────────────────────────────────────────────────────────────────────────────────────────────────────────────────────────────────────────┘            
                                                                                                                                                                                                                                                     