             ┌───────────────────────────
             │                          #
             │                          #
             │                          #
             │                          #
             │      ┌────────┬───────────
             │      │        │
             │      │        │
             │      │        │
             │      =        │                                            ┌────────────────────────────────────────────────────────────────────────────────────────────────────────────────────────────────────────────────────────────────────────────────────────────────────────────────────────────────────────────┐
             │      =        │                                            │       ..............                                                                                                                                                                                       ..............                  │
             │      │        │                                            │       ..............                                                                                                                                                                                       ..............                  │
             │      │        │                                            │       ..............                                                                                        $                                                                                              ..............                  │
             │      │        │                                            │       ..............                                                                                                                                                                                       ..............                  │
             │      │        │                                            │       ┌────────────┐                                                                                                                                                                                       ┌────────────┐                  │
             │      │        │                                            │       │            │                                                                                                                                                                                       │            │                  │
        ─────┘      └────────┴────────────────────────────────────────────┘       │            │~~~~~~~~~~~~~~~~~~~~~~~~~~~~~~~~~~~~~~~~~~~~~~~~~~~~~~~~~~~~~~~~~~~~~~~~~~~~~~~~~~~~~~~~~~~~~~~~~~~~~~~~~~~~~~~~~~~~~~~~~~~~~~~~~~~~~~~~~~~~~~~~~~~~~~~~~~~~~~~~~~~~~~~~~~~~~~~~~~~~~~~│            │                  │
        #                ..............................................           │            │                                                                                direction Skalka                                                                                       │            │                  │
        #                ..............................................           │            │~~~~~~~~~~~~~~~~~~~~~~~~~~~~~~~~~~~~~~~~~~~~~~~~~~~~~~~~~~~~~~~~~~~~~~~~~~~~~~~~~~~~~~~~~~~~~~~~~~~~~~~~~~~~~~~~~~~~~~~~~~~~~~~~~~~~~~~~~~~~~~~~~~~~~~~~~~~~~~~~~~~~~~~~~~~~~~~~~~~~~~~│            │                  │
        #                ──────────────────────────────────────────────           │            │                                                                                                                                                                                       │            │                  │
        #                ..............................................           │            │~~~~~~~~~~~~~~~~~~~~~~~~~~~~~~~~~~~~~~~~~~~~~~~~~~~~~~~~~~~~~~~~~~~~~~~~~~~~~~~~~~~~~~~~~~~~~~~~~~~~~~~~~~~~~~~~~~~~~~~~~~~~~~~~~~~~~~~~~~~~~~~~~~~~~~~~~~~~~~~~~~~~~~~~~~~~~~~~~~~~~~~│            │                  │
        #                ..............................................           │            │                                                                                direction Zličín                                                                                       │            │                  │
        ─────┐      ┌─────────────────────────────────────────────────────┐       │            │~~~~~~~~~~~~~~~~~~~~~~~~~~~~~~~~~~~~~~~~~~~~~~~~~~~~~~~~~~~~~~~~~~~~~~~~~~~~~~~~~~~~~~~~~~~~~~~~~~~~~~~~~~~~~~~~~~~~~~~~~~~~~~~~~~~~~~~~~~~~~~~~~~~~~~~~~~~~~~~~~~~~~~~~~~~~~~~~~~~~~~~│            │                  │
             │      │                                                     │       │            │                                                                                                                                                                                       │            │                  │
             │      │                                                     │       └────────────┘                                                                                                                                                                                       └────────────┘                  │
     ┌───────┤      │                                                     │       ..............                                                                                                                                                                                       ..............                  │
     │       │      │                                                     │       ..............                                                                                                                                                                                       ..............                  │
     │       │      │                                                     │       ..............                                                                                                                                                                                       ..............                  │
     │       │      │                                                     │       ..............                                                                                                                                                                                       ..............                  │
     │       =      │                                                     └────────────────────────────────────────────────────────────────────────────────────────────────────────────────────────────────────────────────────────────────────────────────────────────────────────────────────────────────┐.....│.....│
     │       =      │                                                                                                                                                                                                                                                                                      │.....│.....│
     │       │      │                                                                                                                                                                                                                                                                                      │.....│.....│
     │       │      │                                                                                                                                                                                                                                                                                      │     │     │
     │       │      │                                                                                                                                                                                                                                                                                      │     │     │
     │       │      │                                                                                                                                                                                                                                                                                      │     │     │
─────┴───────┘      │                                                                                                                                                                                                                                                                                      │     │     │
#                   │                                                                                                                                                                                                                                                                               ┌──────┘     │     └──────┐
#                   │                                                                                                                                                                                                                                                                               #                         │
#                   │                                                                                                                                                                                                                                                                               #                         │
#                   │                                                                                                                                                                                                                                                                               #                         │
────────────────────┘                                                                                                                                                                                                                                                                               #                         │
                                                                                                                                                                                                                                                                                                    #                         │
                                                                                                                                                                                                                                                                                                    #                         │
                                                                                                                                                                                                                                                                                                    #                         │
                                                                                                                                                                                                                                                                                                    └─────────────────────────┘