                                                 │####│
                                  │####│         │    │
                                  │    │         │    │
                           │####│ │    │         │    │
                           │    │ │    │         │    │
            │####│         │    │ │    │         │    │                               ┌─────────────────────────────────────────────────────────────────────────────────────────────────────────────────────────────────────────────────────────────────┐
            │    │         │    │ │    │         │    │                               │-----------------------------------------------------------------------------------------------------------------------------------------------------------------│
            │    │         │    │ │    │         │    │                               │                                                    direction Háje                                                                                               │
            │    │         │    │ │    │         │    │                               │-----------------------------------------------------------------------------------------------------------------------------------------------------------------│
            │    │         │    │ │    │         │    │                               │                                                                                                                                                                 │
            │    └─────────┘    └─┘    └─────────┘    └──────┐                        │                                                                                                                                                                 │
            │                                                │                        │                                                                                                                                                                 │
            │                                              ──┴────────────────────────┘                                                             ┌─────────                                                                                          │
            │                                              ...........................                                                              │►........                                                                                          │
            │                                              ...........................                                                              │►........                                                                                          │
            │    ┌────────────────────────┐                ────────────────────────────                                                             ├─────────            @                                                                             │
            │    │                        │                ...........................                                                              │►........                                                                                          │
            │    │                        │                ...........................                                                              │►........                                                                                          │
            │    │                        │                ──┬────────────────────────┐                                                             └─────────                                                                                          │
            │    │                        │                  │                        │                                                                                                                                                                 │
            │    │                        │                  │                        │                                                                                                                                                                 │
            │    │                        │         ┌──┐..│..│                        │                                                                                                                                                                 │
            │    │                        └────┐    │  │..│..│                        │-----------------------------------------------------------------------------------------------------------------------------------------------------------------│
            │    │                             │    │  │▼▼│▼▼│                        │                                                   direction Čakovice                                                                                            │
            │    │                             │    │  └──┴──┘                        │-----------------------------------------------------------------------------------------------------------------------------------------------------------------│
            │    │                             │    │                                 └─────────────────────────────────────────────────────────────────────────────────────────────────────────────────────────────────────────────────────────────────┘
            │    │                             │    │
            │    │                             │    └───────────────────────────────────────
────────────┘    │                             │                                           #
#                │                             │                                           #
#                │                             │                                           #
#                │                             │                                           #
#                │                             └─────────────────┐    ┌─────────────────────
─────────────────┘                                               │    │
                                                                 │    │
                                                                 │    │
                                                                 │    │
                                                                 │    │
                                                                 │    │
                                                                 │    │
                                                                 │    │
                                                                 │####│