                                                                      ┌─────────────────────────────────────────────────────────────────────────────────────────────────────────────────────────────────────────────────────────────────┐
                ┌────────────────────────┐                            │-----------------------------------------------------------------------------------------------------------------------------------------------------------------│
                │                        │                            │                                                    direction Zličín                                                                                             │
                │                        │                            │-----------------------------------------------------------------------------------------------------------------------------------------------------------------│
                │                        │                            │                                                                                                                                                                 │
────────────────┴──    ──────────────────┤                            ├───────────┐     ┌─────┐     ┌─────┐     ┌─────┐     ┌─────┐     ┌─────┐     ┌─────┐     ┌─────┐     ┌─────┐     ┌─────┐     ┌─────┐     ┌─────┐     ┌───────────┤
#                                        │                            │           │     │     │     │     │     │     │     │     │     │     │     │     │     │     │     │     │     │     │     │     │     │     │     │           │
#                                        └────────────────────────────┴───────────┘     └─────┘     └─────┘     └─────┘     └─────┘     └─────┘     └─────┘     └─────┘     └─────┘     └─────┘     └─────┘     └─────┘     └───────────┤
#                                                 ....................                                                                                                                                                                  │
#                                                 ....................                                                                                                                                                                  │
───────────┬───┐                                  ─────────────────────                                                                           @                                                                                     │
           │   │                                  ....................                                                                                                                                                                  │
           │   =                                  ....................                                                                                                                                                                  │
           │   │                         ┌────────────────────────────┬───────────┐     ┌─────┐     ┌─────┐     ┌─────┐     ┌─────┐     ┌─────┐     ┌─────┐     ┌─────┐     ┌─────┐     ┌─────┐     ┌─────┐     ┌─────┐     ┌───────────┤
           │   │                         │                            │           │     │     │     │     │     │     │     │     │     │     │     │     │     │     │     │     │     │     │     │     │     │     │     │           │
           │   │                         │                            ├───────────┘     └─────┘     └─────┘     └─────┘     └─────┘     └─────┘     └─────┘     └─────┘     └─────┘     └─────┘     └─────┘     └─────┘     └───────────┤
           │   =                         │                            │                                                                                                                                                                 │
           │   │                         │                            │-----------------------------------------------------------------------------------------------------------------------------------------------------------------│
───────────┴───┘                         └──────────────              │                                             direction Skalka                                                                                                    │
#                                                      #              │-----------------------------------------------------------------------------------------------------------------------------------------------------------------│
#                                                      #              └─────────────────────────────────────────────────────────────────────────────────────────────────────────────────────────────────────────────────────────────────┘
#                                                      #
#                                                      #
──────────┬────────────────   ────────────────┬─────────
          │                                   │
          └────┐               ┌──────────────┘
               └───────────────┘